{
    "name": "heroquest_base_dungeon",
    "tile": "assets/graphics/tiles/dungeon.jpg",
    "grid": {
        "cols": 26,
        "rows": 19,
        "origin": [21, 16],
        "cell_size": 71.5
    },
    "defaults": {
        "cell_kind": "floor",
        "edge_kind": "wall"
    },
    "wall_encoding": {
        "left": 1,
        "up": 2,
        "right": 4,
        "down": 8
    },
    "walls": [
        [0, 8, 8, 8, 8, 8, 8, 8, 8, 8, 8, 8, 0, 0, 8, 8, 8, 8, 8, 8, 8, 8, 8, 8, 8, 0],
        [4, 3, 2, 2, 6, 3, 2, 2, 6, 3, 2, 6, 1, 4, 3, 2, 6, 3, 2, 2, 6, 3, 2, 2, 6, 1],
        [4, 1, 0, 0, 4, 1, 0, 0, 4, 1, 0, 4, 1, 4, 1, 0, 4, 1, 0, 0, 4, 1, 0, 0, 4, 1],
        [4, 9, 8, 8,12, 9, 8, 8,12, 1, 0, 4, 1, 4, 1, 0, 4, 1, 0, 0, 4, 1, 0, 0, 4, 1],
        [4, 3, 2, 2, 6, 3, 2, 2, 6, 1, 0, 4, 1, 4, 1, 0, 4, 9, 8, 8,12, 9, 8, 8,12, 1],
        [4, 1, 0, 0, 4, 1, 0, 0, 4, 9, 8,12, 1, 4, 9, 8,12, 3, 2, 2, 6, 3, 2, 2, 6, 1],
        [4, 1, 0, 0, 4, 1, 0, 0, 4, 3,10,10, 8, 8,10,10, 6, 1, 0, 0, 4, 1, 0, 0, 4, 1],
        [4, 1, 0, 0, 4, 1, 0, 0, 4, 5, 3, 2, 2, 2, 2, 6, 5, 1, 0, 0, 4, 1, 0, 0, 4, 1],
        [4, 9, 8, 8,12, 9, 8, 8,12, 5, 1, 0, 0, 0, 0, 4, 5, 9, 8, 8,12, 9, 8, 8,12, 1],
        [0,10,10,10,10,10,10,10,10, 4, 1, 0, 0, 0, 0, 4, 1,10,10,10,10,10,10,10,10, 0],
        [4, 3, 2, 2, 6, 3, 6, 3, 6, 5, 1, 0, 0, 0, 0, 4, 5, 3, 2, 2, 6, 3, 2, 2, 6, 1],
        [4, 1, 0, 0, 4, 1, 4, 1, 4, 5, 9, 8, 8, 8, 8,12, 5, 1, 0, 0, 4, 1, 0, 0, 4, 1],
        [4, 1, 0, 0, 4, 9,12, 9,12, 9,10,10, 2, 2,10,10,12, 9, 0, 0, 4, 1, 0, 0, 4, 1],
        [4, 9, 8, 8,12, 3, 2, 2, 6, 3, 2, 6, 1, 4, 3, 2, 2, 6, 9, 8,12, 9, 8, 8,12, 1],
        [4, 3, 2, 2, 6, 1, 0, 0, 4, 1, 0, 4, 1, 4, 1, 0, 0, 4, 3, 2, 6, 3, 2, 2, 6, 1],
        [4, 1, 0, 0, 4, 1, 0, 0, 4, 1, 0, 4, 1, 4, 1, 0, 0, 4, 1, 0, 4, 1, 0, 0, 4, 1],
        [4, 1, 0, 0, 4, 1, 0, 0, 4, 1, 0, 4, 1, 4, 1, 0, 0, 4, 1, 0, 4, 1, 0, 0, 4, 1],
        [4, 9, 8, 8,12, 9, 8, 8,12, 9, 8,12, 1, 4, 9, 8, 8,12, 9, 8,12, 9, 8, 8,12, 1],
        [0, 2, 2, 2, 2, 2, 2, 2, 2, 2, 2, 2, 0, 0, 2, 2, 2, 2, 2, 2, 2, 2, 2, 2, 2, 0]
    ],
    "rooms": [
        [[[1, 1], [4, 3]]],
        [[[5, 1], [8, 3]]],
        [[[1, 4], [4, 8]]],
        [[[5, 4], [8, 8]]],
        [[[9, 1], [11, 5]]],

        [[[1,10], [4, 13]]],
        [[[1,14], [4, 17]]],
        [[[5,10], [6, 12]]],
        [[[7,10], [8, 12]]],
        [[[5,13], [8, 17]]],
        [[[9, 13], [11, 17]]],

        [[[10, 7], [14, 11]]],

        [[[14, 1], [16, 5]]],
        [[[17, 1], [20, 5]]],
        [[[21, 1], [24, 5]]],
        [[[17,5], [20, 8]]],
        [[[21,5], [24, 8]]],

        [[[14,13], [17,17]]],
        [[[17,10], [20,12]], [[18,13], [20,13]]],
        [[[21,10], [24,13]]],
        [[[18,14], [20,17]]],
        [[[21,14], [24,17]]]
    ]
}