{
    "name": "heroquest_base_dungeon",
    "tile": "assets/graphics/tiles/dungeon.jpg",
    "grid": {
        "cols": 26,
        "rows": 19,
        "origin": [21, 16],
        "cell_size": 71.5
    },
    "defaults": {
        "cell_kind": "floor",
        "edge_kind": "wall"
    },
    "wall_encoding": {
        "left": 1,
        "up": 2,
        "right": 4,
        "down": 8
    },
    "walls": [
        [0, 8, 8, 8, 8, 8, 8, 8, 8, 8, 8, 8, 0, 0, 8, 8, 8, 8, 8, 8, 8, 8, 8, 8, 8, 0],
        [4, 3, 2, 2, 6, 3, 2, 2, 6, 3, 2, 6, 1, 4, 3, 2, 6, 3, 2, 2, 6, 3, 2, 2, 6, 1],
        [4, 1, 0, 0, 4, 1, 0, 0, 4, 1, 0, 4, 1, 4, 1, 0, 4, 1, 0, 0, 4, 1, 0, 0, 4, 1],
        [4, 9, 8, 8,12, 9, 8, 8,12, 1, 0, 4, 1, 4, 1, 0, 4, 1, 0, 0, 4, 1, 0, 0, 4, 1],
        [4, 3, 2, 2, 6, 3, 2, 2, 6, 1, 0, 4, 1, 4, 1, 0, 4, 9, 8, 8,12, 9, 8, 8,12, 1],
        [4, 1, 0, 0, 4, 1, 0, 0, 4, 9, 8,12, 1, 4, 9, 8,12, 3, 2, 2, 6, 3, 2, 2, 6, 1],
        [4, 1, 0, 0, 4, 1, 0, 0, 4, 3,10,10, 8, 8,10,10, 6, 1, 0, 0, 4, 1, 0, 0, 4, 1],
        [4, 1, 0, 0, 4, 1, 0, 0, 4, 5, 3, 2, 2, 2, 2, 6, 5, 1, 0, 0, 4, 1, 0, 0, 4, 1],
        [4, 9, 8, 8,12, 9, 8, 8,12, 5, 1, 0, 0, 0, 0, 4, 5, 9, 8, 8,12, 9, 8, 8,12, 1],
        [0,10,10,10,10,10,10,10,10, 4, 1, 0, 0, 0, 0, 4, 1,10,10,10,10,10,10,10,10, 0],
        [4, 3, 2, 2, 6, 3, 6, 3, 6, 5, 1, 0, 0, 0, 0, 4, 5, 3, 2, 2, 6, 3, 2, 2, 6, 1],
        [4, 1, 0, 0, 4, 1, 4, 1, 4, 5, 9, 8, 8, 8, 8,12, 5, 1, 0, 0, 4, 1, 0, 0, 4, 1],
        [4, 1, 0, 0, 4, 9,12, 9,12, 9,10,10, 2, 2,10,10,12, 9, 0, 0, 4, 1, 0, 0, 4, 1],
        [4, 9, 8, 8,12, 3, 2, 2, 6, 3, 2, 6, 1, 4, 3, 2, 2, 6, 9, 8,12, 9, 8, 8,12, 1],
        [4, 3, 2, 2, 6, 1, 0, 0, 4, 1, 0, 4, 1, 4, 1, 0, 0, 4, 3, 2, 6, 3, 2, 2, 6, 1],
        [4, 1, 0, 0, 4, 1, 0, 0, 4, 1, 0, 4, 1, 4, 1, 0, 0, 4, 1, 0, 4, 1, 0, 0, 4, 1],
        [4, 1, 0, 0, 4, 1, 0, 0, 4, 1, 0, 4, 1, 4, 1, 0, 0, 4, 1, 0, 4, 1, 0, 0, 4, 1],
        [4, 9, 8, 8,12, 9, 8, 8,12, 9, 8,12, 1, 4, 9, 8, 8,12, 9, 8,12, 9, 8, 8,12, 1],
        [0, 2, 2, 2, 2, 2, 2, 2, 2, 2, 2, 2, 0, 0, 2, 2, 2, 2, 2, 2, 2, 2, 2, 2, 2, 0]
    ]
}